BBBB BBBBBB BBBB
B    BBBB   BBBB
BBBB BB BB   BBB
BBBB         BBB
X     BBBB     X
BBBB       BB BB
BBBB       BB BB
BBB    O   BBBBB
BBB          BBB
BB     O  BB  BB
BBB      BBB    
BBB  BBBBBBB  B 
BBB  BBBBB     B
B    BBBBB     B
B BB BBBBB  BBBB
BBBB BBBBB  BBBB
