BBBB   BBBBBBBBB
BB B   BBBBBBBBB
B    BB  BB   BB
B BB BB       BB
X    BB        X
BB B    BBB     
B     BBBBB     
BBBB  BBBBB     
BBBB   B        
 BBBBB     BBB  
   BBB     BBB  
X  BBBBBBBBBBBBB
BBBBBBBBBBBBBBBB
BBBBBBBBBBBBBBBB
BBBBBBBBBBBBBBBB
BBBBBBBBBBBBBBBB
